NO texture/1.xpm
SO       ./texture/2.xpm

WE         ./texture/3.xpm


EA          ./texture/4.xpm

F 0,0,0

C 0,0,0



111111111111111111111111111111
100000000000000000000000000001
100000000001111100000000000001
100000000001000100000011100001
100000000001000100000011100001
100000000001111100000011100001                   
100001111111111111110000000001                              
100001000000000000010000S00001
100001000011111110010000100001
111111111111111111111111111111
