NO texture/1.xpm
SO       ./texture/2.xpm

WE         ./texture/3.xpm


EA          ./texture/4.xpm

F 30,30,30

C 0,0,20



111111111111111111111111111111
100000000000000000000000000001
100000000001111100000000000001
1000000000010001000000 1100001
1000000000010001000000 1100001
1000000000011111000000 0000001                   
100001111111111111    N      1                          
10000100 0000000000000 0000001
1000010000111111100000 0000001
1000000000000000000000 0000001
1000000000011111000000 0000001
100000000001000100000011100001
100000000001000100000011100001
100000000001111100000011100001                   
100001111111111111110000000001                              
111111111111111111111111111111                             
                             
